
Abkhazia -- Abkhazia

Afghanistan -- Islamic Republic of Afghanistan

Albania -- Albania -- Republic of Albania

Algeria -- Algeria -- People's Democratic Republic of Algeria

Andorra -- Andorra -- Principality of Andorra

Angola -- Angola -- Republic of Angola

Antigua and Barbuda -- Antigua and Barbuda

Argentina -- Argentina -- Argentine Republic -- United Provinces of the Río de la Plata -- Argentine Republic -- Argentine Confederation -- Argentine Nation

Armenia -- Armenia -- Republic of Armenia

Australia -- Australia -- Commonwealth of Australia

Azerbaijan -- Azerbaijan -- Republic of Azerbaijan

Bahamas -- Bahamas, The -- Commonwealth of The Bahamas

Bahrain -- Bahrain -- Kingdom of Bahrain

Bangladesh -- Bangladesh -- People's Republic of Bangladesh

Barbados -- Barbados

Belarus -- Belarus -- Republic of Belarus

Belgium -- Belgium -- Kingdom of Belgium

Belize -- Belize

Benin -- Benin -- Republic of Benin

Bhutan -- Bhutan -- Kingdom of Bhutan

Bolivia -- Bolivia -- Plurinational State of Bolivia

Bosnia and Herzegovina -- Bosnia and Herzegovina

Bosnia and Herzegovina -- Federation of Bosnia and Herzegovina -- Republika Srpska

Botswana -- Botswana -- Republic of Botswana

Brazil -- Brazil -- Federative Republic of Brazil

Brunei -- Brunei -- Nation of Brunei, the Abode of Peace

Bulgaria -- Bulgaria -- Republic of Bulgaria

Burkina Faso -- Burkina Faso

Burundi -- Burundi -- Republic of Burundi

Cambodia -- Cambodia -- Kingdom of Cambodia

Cameroon -- Cameroon -- Republic of Cameroon

Canada -- Canada -- Dominion of Canada 

Cape Verde -- Cape Verde -- Republic of Cabo Verde

Central African Republic -- Central African Republic

Chad -- Chad -- Republic of Chad

Chile -- Chile -- Republic of Chile

China -- China -- People's Republic of China -- PRC 

Hong Kong -- Hong Kong

Macau -- Macau

Colombia -- Colombia -- Republic of Colombia

Comoros -- Comoros -- Union of the Comoros

Congo -- Congo, Democratic Republic of the -- Congo, Democratic Republic of the -- Congo-Kinshasa -- Zaire

Congo, Republic of the -- Congo, Republic of the -- Congo-Brazzaville

Costa Rica -- Costa Rica -- Republic of Costa Rica

Croatia -- Croatia -- Republic of Croatia

Cuba -- Cuba -- Republic of Cuba

Cyprus -- Cyprus -- Republic of Cyprus

Czech Republic -- Czech Republic -- Czechia

Denmark -- Denmark -- Kingdom of Denmark

Faroe Islands -- Faroe Islands

Greenland -- Greenland

Djibouti -- Djibouti -- Republic of Djibouti

Dominica -- Dominica -- Commonwealth of Dominica

Dominican Republic -- Dominican Republic

East Timor -- East Timor -- Democratic Republic of Timor-Leste -- Timor-Leste

Ecuador -- Ecuador -- Republic of Ecuador

Egypt -- Egypt -- Arab Republic of Egypt

El Salvador -- El Salvador -- Republic of El Salvador

Equatorial Guinea -- Equatorial Guinea -- Republic of Equatorial Guinea

Eritrea -- Eritrea -- State of Eritrea

Estonia -- Estonia -- Republic of Estonia

Eswatini -- Eswatini -- Kingdom of Eswatin -- Kingdom of Swaziland -- Swaziland

Ethiopia -- Ethiopia -- Federal Democratic Republic of Ethiopia

Fiji -- Fiji -- Republic of Fiji

Finland -- Finland -- Republic of Finland
Åland -- Åland

France -- France -- French Republic -- Clipperton Island -- French Polynesia -- New Caledonia -- Saint Barthélemy -- Collectivity of Saint Martin --Saint Martin -- Saint Pierre and Miquelon -- Wallis and Futuna

Gabon -- Gabon -- Gabonese Republic

Gambia -- Gambia, The -- Republic of The Gambia

Georgia -- Georgia

Germany -- Germany -- Federal Republic of Germany

Ghana -- Ghana -- Republic of Ghana

Greece -- Greece -- Hellenic Republic

Grenada -- Grenada

Guatemala -- Guatemala -- Republic of Guatemala

Guinea -- Guinea -- Republic of Guinea -- Guinea-Conakry

Guinea-Bissau -- Guinea-Bissau -- Republic of Guinea-Bissau

Guyana -- Guyana -- Co-operative Republic of Guyana

Haiti -- Haiti -- Republic of Haiti

Honduras -- Honduras -- Republic of Honduras

Hungary -- Hungary

Iceland -- Iceland -- Republic of Iceland

India -- India -- Republic of India

Indonesia -- Indonesia -- Republic of Indonesia

Iran -- Iran -- Islamic Republic of Iran

Iraq -- Iraq -- Republic of Iraq

Ireland -- Ireland -- Republic of Ireland -- Éire

Israel -- Israel -- State of Israel

Italy -- Italy -- Italian Republic

Ivory Coast -- Ivory Coast -- Republic of Côte d'Ivoire -- Côte d'Ivoire

Jamaica -- Jamaica

Japan -- Japan

Jordan -- Jordan -- Hashemite Kingdom of Jordan

Kazakhstan -- Kazakhstan -- Republic of Kazakhstan

Kenya -- Kenya -- Republic of Kenya

Kiribati -- Kiribati -- Republic of Kiribati

North Korea -- Korea, North -- Democratic People's Republic of Korea -- DPRK

South Korea -- Korea, South -- Republic of Korea

Kuwait -- Kuwait -- State of Kuwait

Kyrgyzstan -- Kyrgyzstan -- Kyrgyz Republic

Laos -- Laos -- Lao People's Democratic Republic

Latvia -- Latvia -- Republic of Latvia

Lebanon -- Lebanon -- Lebanese Republic

Lesotho -- Lesotho -- Kingdom of Lesotho

Liberia -- Liberia -- Republic of Liberia

Libya -- Libya -- State of Libya

Liechtenstein -- Liechtenstein -- Principality of Liechtenstein

Lithuania -- Lithuania -- Republic of Lithuania

Luxembourg -- Luxembourg -- Grand Duchy of Luxembourg

Madagascar -- Madagascar -- Republic of Madagascar

Malawi -- Malawi -- Republic of Malawi

Malaysia -- Malaysia

Maldives -- Maldives -- Republic of Maldives

Mali -- Mali -- Republic of Mali

Malta -- Malta -- Republic of Malta

Marshall Islands -- Marshall Islands -- Republic of the Marshall Islands

Mauritania -- Mauritania -- Islamic Republic of Mauritania

Mauritius -- Mauritius -- Republic of Mauritius

Mexico -- Mexico -- United Mexican States

Micronesia -- Micronesia -- Federated States of Micronesia

Moldova -- Moldova -- Republic of Moldova

Monaco -- Monaco -- Principality of Monaco

Mongolia -- Mongolia

Montenegro -- Montenegro

Morocco -- Morocco -- Kingdom of Morocco

Mozambique -- Mozambique -- Republic of Mozambique

Myanmar -- Myanmar -- Republic of the Union of Myanmar -- Burma -- Wa State

Namibia -- Namibia -- Republic of Namibia

Nauru -- Nauru -- Republic of Nauru

Nepal -- Nepal -- Federal Democratic Republic of Nepal

Netherlands -- Kingdom of the Netherlands -- Aruba -- Curaçao -- Netherlands -- Sint Maarten

New Zealand -- New Zealand -- Tokelau -- Ross Dependency -- Cook Islands -- Niue

Nicaragua -- Nicaragua -- Republic of Nicaragua

Niger -- Niger -- Republic of Niger

Nigeria -- Nigeria -- Federal Republic of Nigeria

North Macedonia -- North Macedonia -- Republic of North Macedonia -- Republic of Macedonia -- the former Yugoslav Republic of Macedonia

Norway -- Norway -- Kingdom of Norway -- Jan Mayen -- Bouvet Island -- Peter I Island -- Queen Maud Land -- Svalbard

Oman -- Oman -- Sultanate of Oman

Pakistan -- Pakistan -- Islamic Republic of Pakistan

Palau -- Palau -- Republic of Palau

Palestine -- Palestine -- State of Palestine

Panama -- Panama -- Republic of Panama

Papua New Guinea -- Papua New Guinea -- Independent State of Papua New Guinea

Paraguay -- Paraguay -- Republic of Paraguay

Peru -- Peru -- Republic of Peru

Philippines -- Philippines -- Republic of the Philippines

Poland -- Poland -- Republic of Poland

Portugal -- Portugal -- Portuguese Republic -- Azores -- the Azores -- Madeira

Qatar -- Qatar -- State of Qatar

Romania -- Romania

Russia -- Russia -- Russian Federation

Rwanda -- Rwanda -- Republic of Rwanda

Saint Kitts and Nevis -- Saint Kitts and Nevis -- Federation of Saint Christopher and Nevis

Saint Lucia -- Saint Lucia

Saint Vincent and the Grenadines -- Saint Vincent and the Grenadines

Samoa -- Samoa -- Independent State of Samoa

San Marino -- San Marino -- Republic of San Marino

São Tomé and Príncipe -- São Tomé and Príncipe -- Democratic Republic of São Tomé and Príncipe

Saudi Arabia -- Saudi Arabia -- Kingdom of Saudi Arabia

Sealand -- Sealand

Scotland -- Scotland

Senegal -- Senegal -- Republic of Senegal

Serbia -- Serbia -- Republic of Serbia

Seychelles -- Seychelles -- Republic of Seychelles

Sierra Leone -- Sierra Leone -- Republic of Sierra Leone

Singapore -- Singapore -- Republic of Singapore

Slovakia -- Slovakia -- Slovak Republic

Slovenia -- Slovenia -- Republic of Slovenia

Solomon Islands -- Solomon Islands

Somalia -- Somalia -- Federal Republic of Somalia

South Africa -- South Africa -- Republic of South Africa

South Sudan -- South Sudan -- Republic of South Sudan

Spain -- Spain -- Kingdom of Spain

Sri Lanka -- Sri Lanka -- Democratic Socialist Republic of Sri Lanka Dominion of Ceylon -- Ceylon

Sudan -- Sudan -- Republic of the Sudan

Sweden -- Sweden -- Kingdom of Sweden

Switzerland -- Switzerland -- Swiss Confederation

Syria -- Syria -- Syrian Arab Republic

Tajikistan -- Tajikistan -- Republic of Tajikistan

Tanzania -- Tanzania -- United Republic of Tanzania

Thailand -- Thailand -- Kingdom of Thailand

Togo -- Togo -- Togolese Republic

Tonga -- Tonga -- Kingdom of Tonga

Trinidad and Tobago -- Trinidad and Tobago -- Republic of Trinidad and Tobago -- Trinidad -- Tobago

Tunisia -- Tunisia -- Republic of Tunisia

Turkey -- Turkey -- Republic of Turkey

Turkmenistan -- Turkmenistan

Tuvalu -- Tuvalu

Uganda -- Uganda -- Republic of Uganda

Ukraine -- Ukraine

United Arab Emirates -- United Arab Emirates

United Kingdom -- United Kingdom -- United Kingdom of Great Britain and Northern Ireland -- Akrotiri and Dhekelia -- Anguilla -- Bermuda -- British Indian Ocean Territory -- British Virgin Islands -- Cayman Islands -- Falkland Islands -- Gibraltar -- Montserrat -- Pitcairn Islands -- Saint Helena, Ascension and Tristan da Cunha -- South Georgia and the South Sandwich Islands -- Turks and Caicos Islands -- British Antarctic Territory -- Bailiwick of Guernsey -- Guernsey -- Isle of Man -- Jersey

United States -- United States -- United States of America -- American Samoa -- Samoa -- Guam -- Northern Marina Islands -- Puerto Rico -- U.S. Virgin Islands -- Baker Island -- Howland Island -- Jarvis Island -- Johnston Atoll -- Kingman Reef -- Midway Atoll -- Navassa Island -- Wake Island -- Bajo Nuevo Bank -- Serranilla Bank -- Marshall Islands -– Republic of the Marshall Islands -- Micronesia -– Federated States of Micronesia -- Palau -– Republic of Palau

Uruguay -- Uruguay -- Oriental Republic of Uruguay

Uzbekistan -- Uzbekistan -- Republic of Uzbekistan

Vanuatu -- Vanuatu -- Republic of Vanuatu

Vatican City -- Vatican City -- Vatican City State -- Holy See

Venezuela -- Venezuela -- Bolivarian Republic of Venezuela

Vietnam -- Vietnam -- Socialist Republic of Vietnam

Yemen -- Yemen -- Republic of Yemen

Zambia -- Zambia -- Republic of Zambia

Zimbabwe -- Zimbabwe -- Republic of Zimbabwe

Abkhazia -- Abkhazia -- Republic of Abkhazia

Artsakh -- Artsakh -- Republic of Artsakh -- Nagorno-Karabakh Republic

Cook Islands -- Cook Islands

Kosovo -- Kosovo -- Republic of Kosovo

Niue -- Niue

Northern Cyprus -- Northern Cyprus -- Turkish Republic of Northern Cyprus

SADR -- Sahrawi Arab Democratic Republic

Somaliland -- Somaliland -- Republic of Somaliland

South Ossetia -- South Ossetia -- Republic of South Ossetia–the State of Alania

Taiwan -- Republic of China|name=Taiwan -- Republic of China

Transnistria -- Transnistria -- Pridnestrovian Moldavian Republic -- Pridnestrovie
